1111111111111111111111
1P100010001000100010E1
1010101010101010101001
1010101010101010101001
1010101010101010101001
1010101010101010101001
1010101010101010101001
1010101010101010101001
1C10101010101010101001
1010101010101010101101
1000100010001000100001
1111111111111111111111
